3 3
3 3 3 3 3 3 3 3 3 3 3 3 3 3 3 3 3 3 3 3 3 3 3 3 3 3 3 3 3 3 3 3 3 3 3 3 3 3 3 3 3 3
3 ^ ^ b ^ ^ 3 d 0 0 0 0 3 0 0 0 k 0 0 0 0 X 3 [ j [ A 3 ` 0 0 0 0 0 0 0 C 6 0 ? ] 3
3 0 0 0 0 0 3 3 3 3 3 ? 3 0 3 3 0 3 3 3 3 3 3 0 0 0 0 3 0 0 0 0 0 0 0 0 0 3 E 3 H 3
3 ^ [ 0 [ ^ 3 C ^ g ^ U 3 0 0 3 0 3 3 0 0 0 3 0 0 0 X 3 0 0 0 0 0 0 0 0 0 3 0 3 0 3
3 0 0 0 0 0 3 0 0 0 0 0 8 0 3 0 3 0 3 0 3 0 3 8 3 3 3 3 0 0 0 0 0 0 0 0 0 3 0 3 0 3
3 ^ 0 0 0 ^ 3 0 0 0 0 0 3 0 0 0 0 0 3 0 3 0 3 0 0 @ \ 3 0 0 0 0 0 0 0 k 0 3 0 3 0 3
3 3 3 < 3 3 3 0 0 0 0 0 3 0 3 0 0 0 3 0 3 0 3 ^ 0 \ @ 3 0 0 k 0 0 0 0 0 0 3 U 3 0 3
3 0 4 0 4 0 3 Z 0 0 0 Z 3 0 3 0 0 0 3 0 3 0 3 3 8 3 3 3 0 0 0 0 0 0 0 0 0 3 0 3 0 3
3 0 4 0 4 0 3 3 3 8 3 3 3 0 0 3 0 0 0 0 3 0 3 \ \ \ L 3 0 0 0 0 0 0 0 0 0 3 0 3 0 3
3 0 4 0 4 0 3 X ^ 0 ^ X 3 3 3 0 0 3 3 3 3 0 3 \ \ \ \ 3 0 0 0 0 0 k 0 0 0 3 0 3 0 3
3 0 4 < 4 0 3 0 0 0 0 0 3 0 0 0 3 0 0 0 0 k 3 \ \ \ \ 3 0 0 0 0 0 0 0 0 0 3 0 3 0 3
3 0 4 0 4 0 3 0 A 0 A 0 3 0 3 3 3 0 3 3 3 3 3 \ \ \ \ 3 0 0 0 0 0 0 0 0 0 3 0 3 0 3
3 0 4 0 4 0 3 @ Y h Y @ 3 0 3 0 0 0 0 0 0 0 3 \ \ \ \ 3 0 0 0 0 0 0 0 k 0 3 U 3 0 3
3 0 4 0 4 0 3 0 0 0 0 0 3 0 3 3 3 3 0 3 3 0 3 3 3 8 3 3 0 0 k 0 0 0 0 0 0 3 0 3 0 3
3 0 4 < 4 0 3 0 0 0 0 0 3 0 0 0 0 3 0 3 0 0 3 0 [ 0 [ 3 0 0 0 0 0 0 0 0 0 3 0 3 0 3
3 0 4 0 4 0 3 0 0 0 0 0 3 3 3 3 0 3 0 0 3 0 3 0 0 0 0 3 0 0 0 0 0 0 0 0 0 3 0 3 0 3
3 0 4 0 4 0 3 0 0 0 0 0 3 0 0 0 0 3 0 0 0 0 3 ^ G ^ 0 3 0 0 0 0 0 k 0 0 0 3 0 3 0 3
3 0 4 0 4 0 3 0 0 0 0 0 3 0 3 3 3 3 k 0 3 0 3 0 0 0 0 3 0 0 0 0 0 0 0 0 0 3 0 3 0 3
3 0 4 < 4 0 3 0 0 0 0 0 3 0 3 3 3 3 3 0 3 0 3 0 0 0 0 3 0 0 0 0 0 0 0 0 A 3 0 3 0 3
3 0 4 0 4 0 3 X ^ 0 ^ X 3 0 0 0 0 0 3 0 3 3 3 3 3 3 8 3 8 3 3 3 3 3 3 3 3 3 0 3 0 3
3 0 4 B 4 0 3 3 3 8 3 3 3 3 3 3 3 ` 3 0 0 0 3 ^ [ 0 0 0 0 0 [ ^ 3 0 0 0 X 3 0 3 0 3
3 0 4 0 4 0 3 0 0 0 3 B 3 X 0 0 3 3 3 3 3 0 3 0 g 0 0 h 0 0 i 0 3 0 C @ C 3 0 3 0 3
3 0 4 < 4 0 3 0 3 0 3 0 3 3 3 0 0 0 0 0 0 0 3 0 0 0 0 0 0 0 0 0 8 0 A C A 3 0 3 0 3
3 0 4 0 4 0 3 0 3 0 3 A 3 0 0 0 3 3 0 3 3 3 3 X 0 0 0 0 0 0 0 X 3 0 C @ C 3 0 3 0 3
3 0 4 0 4 0 3 0 3 0 3 0 3 0 3 3 3 3 0 0 0 0 3 ^ 0 0 0 0 0 0 0 ^ 3 0 0 0 X 3 0 3 0 3
3 0 4 0 4 0 3 0 3 0 3 ? 3 0 3 3 3 3 3 3 0 3 3 3 3 3 3 0 3 3 3 3 3 3 3 3 3 3 0 3 0 3
3 3 3 < 3 3 3 0 3 0 3 0 3 0 0 0 3 0 0 0 0 0 3 3 3 3 3 8 3 5 5 5 5 5 5 5 5 5 ] 3 0 3
3 ^ [ 0 [ ^ 3 0 3 0 3 0 3 3 3 0 3 0 3 3 3 0 3 U 0 0 0 0 3 5 0 0 0 0 0 ^ 0 5 0 3 0 3
3 0 0 0 0 0 3 0 3 0 3 0 3 ` 3 0 3 0 0 0 0 3 3 ^ 0 0 0 [ 3 5 0 0 0 N 0 X 0 5 0 3 0 3
3 0 0 0 0 0 8 0 3 0 3 0 3 0 3 0 3 3 0 3 3 0 8 0 0 0 0 m 3 5 0 0 0 o 0 0 _ 5 0 3 0 3
3 0 0 q 0 0 3 0 3 0 3 0 3 0 3 0 3 0 0 0 0 0 3 ] 0 0 0 0 8 0 0 0 0 S 0 c 0 5 0 3 0 3
3 ^ [ 0 [ ^ 3 A 3 0 0 0 3 0 0 k 3 0 3 0 3 F 3 U 0 0 0 0 3 5 0 0 0 p 0 0 0 5 0 3 0 3
3 3 3 8 3 3 3 3 3 3 3 3 3 3 3 3 3 3 3 3 3 3 3 3 3 3 3 8 3 5 0 0 0 Q 0 X 0 5 0 3 0 3
3 C 0 0 0 8 0 0 0 < 0 B 0 < 0 0 < 0 0 < 0 0 < 0 0 < 0 A 3 5 0 0 0 0 0 ^ 0 5 0 I 0 3
3 3 3 3 3 3 3 3 3 3 3 3 3 3 3 3 3 3 3 3 3 3 3 3 3 3 3 3 3 5 5 5 5 5 5 5 5 5 3 3 3 3
