1 1
1 1 1 1 1 5 5 5 5 5 5 5 5 5 1 1 1 1 1 1 1 1 1 1 1 1 1 1
1 X 0 0 0 5 ^ _ 0 c 0 0 ^ 5 1 U 0 n 1 0 0 1 V 1 0 b [ 1
1 ` 0 1 B 5 0 M P o p T 0 5 1 0 0 0 8 0 V 1 V 1 0 0 0 1
1 0 0 1 @ 5 0 0 0 0 0 0 0 5 1 0 0 0 1 0 V V W W 0 0 0 1
1 m 0 1 1 5 0 0 0 0 0 0 0 5 1 k 0 0 1 1 1 1 1 1 1 6 1 1
1 0 m 1 1 5 ^ 0 0 0 0 0 ^ 5 1 0 0 0 0 0 1 0 0 0 1 0 0 1
1 0 0 1 1 5 5 5 5 9 5 5 5 5 1 0 0 0 1 V 1 0 1 0 0 1 0 1
1 0 0 1 1 1 1 1 0 l 0 1 1 1 1 1 m 1 1 0 0 0 0 1 0 0 0 1
1 0 0 1 @ 0 0 < 0 0 0 : 0 0 U 1 1 1 0 0 1 1 0 0 1 1 1 1
1 0 0 1 0 0 0 1 0 0 0 1 0 0 0 m 1 D 1 C 1 B 0 1 1 U 1 1
1 0 0 1 1 1 V 1 0 0 0 1 0 0 0 I 1 0 1 1 1 0 0 0 0 0 0 1
1 \ \ 1 @ 0 0 1 0 0 0 1 0 1 1 1 1 0 1 0 0 0 1 1 0 1 n 1
1 0 0 1 0 0 L 1 1 8 1 1 0 0 0 ` 1 U 0 0 1 0 1 E 0 1 0 1
1 0 0 1 V 1 1 1 V 0 V 1 1 1 1 1 1 1 1 0 1 0 0 0 1 1 0 1
1 0 0 0 0 0 0 0 0 0 0 0 0 0 0 U 1 U 0 0 0 1 1 0 0 1 0 1
1 0 0 0 0 0 0 0 0 0 0 0 0 0 0 0 0 U 1 1 0 0 1 1 0 0 0 1
1 0 0 1 1 1 1 1 1 1 1 1 1 : 1 1 1 1 U 0 0 0 0 0 0 1 A 1
1 0 0 1 X 0 0 0 m X 1 [ 0 0 0 A [ 1 1 1 1 1 1 1 1 1 1 1
1 0 0 1 0 0 0 0 0 0 1 0 0 0 0 0 0 1 0 0 0 H 0 1 e 1 ` 1
1 1 ] 1 0 0 0 0 0 0 : 0 0 0 0 0 0 7 0 0 C n 0 1 0 1 0 1
1 V 0 = 0 0 0 0 0 0 1 0 0 0 0 0 0 1 0 0 0 0 0 1 0 1 0 1
1 G 0 1 X 0 0 0 0 X 1 [ 0 0 0 0 [ 1 0 0 0 0 D 1 0 1 0 1
1 1 1 1 1 1 1 : 1 1 1 1 1 1 1 : 1 1 1 1 1 1 1 1 = 1 0 1
1 0 0 0 1 ^ 0 0 0 ^ 1 0 0 C 1 0 0 \ 0 0 0 0 k 0 0 \ 0 1
1 0 F 0 9 0 0 0 0 0 : 0 0 @ 1 0 0 0 0 k B 0 0 0 0 0 0 1
1 0 0 0 1 ^ 0 q 0 ^ 1 0 0 0 1 0 0 0 0 0 0 0 0 \ 0 0 0 1
1 1 1 1 1 1 1 1 1 1 1 1 1 1 1 1 1 1 1 1 1 1 1 1 1 1 1 1
