2 2
2 2 2 2 2 2 2 2 2 2 2 2 2 2 2 2 2 2 2 2 2 2 2 2 2 2 2 2 2 2 2 2 2 2 2 2 2 2 2 2 2 2 2
2 0 0 I 0 0 < 0 0 0 2 2 2 0 0 \ 0 0 2 U 0 0 0 U 2 U 0 0 0 U 2 0 0 0 0 0 2 0 0 0 0 0 2
2 0 2 2 2 2 2 Z 0 0 2 2 2 0 0 \ 0 0 > 0 0 W 0 0 2 W W W W W 2 0 0 0 0 0 > 0 0 0 0 0 2
2 0 2 0 0 0 < 0 0 0 2 2 2 \ \ d \ \ 2 0 W K W 0 2 H 0 0 0 0 > 0 0 0 0 0 2 0 0 0 0 0 2
2 0 2 0 2 2 2 Z 0 0 2 2 2 0 0 \ 0 0 2 0 0 0 0 0 2 W W W W W 2 0 0 0 0 0 2 0 0 0 0 0 2
2 0 2 D 2 B < 0 0 0 2 2 2 0 0 \ 0 0 2 U 0 0 0 U 2 U 0 0 0 U 2 0 0 0 0 0 2 0 0 0 0 0 2
2 < 2 < 2 < 2 2 2 7 2 2 2 2 2 2 > 2 2 2 2 9 2 2 2 2 2 2 2 2 2 2 2 2 2 > 2 2 > 2 2 2 2
2 0 0 0 0 0 4 0 0 0 0 [ 2 ^ 0 0 0 ^ 2 X 0 0 0 X 2 [ 0 0 0 [ 2 0 0 0 0 0 2 0 0 0 0 0 2
2 0 0 0 0 0 4 0 0 0 0 0 2 0 0 W 0 0 2 0 0 0 0 0 2 0 0 C 0 0 2 0 0 0 0 0 2 0 0 0 0 0 2
2 0 0 @ 0 0 2 0 0 0 0 0 2 0 W I 0 0 9 0 0 0 0 0 9 0 0 J C 0 2 0 0 0 0 0 2 0 0 0 0 0 2
2 U 0 0 0 0 < 0 0 0 0 0 2 0 0 W 0 0 2 0 0 0 0 0 2 0 0 C 0 0 2 0 0 0 0 0 2 0 0 0 0 0 2
5 5 5 5 5 5 5 5 0 m 0 0 2 ^ 0 0 0 ^ 2 X 0 0 0 X 2 [ 0 0 0 [ 2 0 0 E 0 0 > 0 0 0 0 0 2
5 ^ 0 0 0 0 ^ 5 0 0 0 0 2 2 2 2 2 2 2 2 2 : 2 2 2 2 2 2 2 2 2 2 2 > 2 2 2 2 2 2 > 2 2
5 0 0 R 0 0 0 5 0 0 0 0 0 0 0 0 A 0 2 \ 0 0 0 \ 2 0 0 0 0 0 > 0 0 0 0 0 2 0 0 0 E 0 2
5 0 0 p 0 0 0 5 0 0 0 0 ^ 0 ^ 0 ^ 0 2 0 0 0 0 0 2 0 0 0 0 0 2 0 0 0 0 0 2 0 0 0 0 0 2
5 c 0 o 0 0 0 9 0 0 0 0 0 0 0 0 0 0 : 0 0 l 0 0 : 0 0 ^ 0 0 2 0 0 0 0 0 2 0 0 0 0 0 2
5 _ 0 S 0 0 0 5 0 0 0 0 ^ 0 ^ 0 ^ 0 2 0 0 0 0 0 2 0 0 0 0 0 2 0 0 0 0 0 2 0 0 0 0 0 2
5 0 0 T 0 0 0 5 0 0 0 0 0 0 0 0 0 0 2 \ 0 0 0 \ 2 0 0 0 0 @ 2 0 0 0 0 0 2 0 0 0 0 0 2
5 ^ 0 0 0 0 ^ 5 0 0 0 0 2 2 2 2 2 2 2 2 2 : 2 2 2 2 2 : 2 2 2 2 2 2 2 2 2 2 > 2 2 2 2
5 5 5 5 5 5 5 5 0 m 0 0 2 k 0 0 0 0 2 W 0 0 0 W 2 U 0 0 0 U 2 Y 0 0 n ] 2 0 0 0 0 0 2
2 2 2 2 2 2 2 0 0 0 0 0 2 0 0 0 0 0 2 W 0 0 0 0 2 0 0 0 0 U 2 0 0 0 n ] 2 0 0 0 0 0 2
2 m 0 0 0 0 : 0 0 0 0 0 2 m 0 0 0 0 6 0 0 0 0 0 : 0 0 0 0 0 : 0 0 ` n ] ] 0 0 0 0 0 2
2 0 2 2 2 2 2 0 0 0 0 0 2 0 0 0 0 0 2 W 0 q 0 0 2 0 0 0 0 0 2 0 0 0 n ] 2 0 0 0 0 0 2
2 0 0 B > D 2 U Y h Y U 2 k 0 0 0 0 2 W 0 0 0 W 2 U 0 0 0 U 2 U 0 0 n ] 2 0 0 0 0 0 2
2 2 2 2 > 2 2 2 2 2 2 2 2 2 2 : 2 2 2 2 2 : 2 2 2 2 2 : 2 2 2 2 2 2 2 2 2 2 2 2 2 > 2
2 X 0 0 ] 0 2 ^ 0 0 0 0 2 ^ 0 0 [ 2 2 0 0 0 0 0 2 A 0 0 0 0 2 0 0 0 0 U 2 U 0 0 0 U 2
2 g 0 0 0 0 0 0 0 0 0 0 0 0 0 0 0 2 2 0 0 0 0 k 2 0 0 0 0 0 2 0 0 0 0 ^ 2 0 C C C 0 2
2 X 0 0 0 0 2 ^ 0 0 0 0 2 ^ 0 0 U 2 2 0 0 0 0 0 2 0 0 0 0 0 ; 0 0 0 k G 2 0 C C C 0 2
2 2 0 0 0 2 2 2 2 2 2 2 2 2 2 2 2 2 2 0 0 j 0 0 2 0 V m V 0 2 0 0 0 0 ^ 2 0 C C C 0 2
2 2 0 0 0 2 U 0 0 0 W 0 2 0 C 0 0 0 > 0 0 @ 0 0 2 B 0 V 0 0 2 \ 0 0 0 0 2 U 0 0 0 U 2
2 ^ 0 0 0 0 0 0 0 0 F W 2 C e C 0 0 2 2 2 2 2 2 2 2 2 2 2 2 2 2 2 2 2 2 2 2 2 2 2 2 2
2 2 0 0 0 2 U 0 0 0 W 0 2 0 C 0 0 0 2 2 k 0 0 0 0 2 2 m 0 0 m m 0 m 2 2 k 0 0 m 0 2 2
2 2 0 0 0 2 2 2 2 2 2 2 2 2 2 2 2 2 2 0 0 0 0 0 k 0 2 0 0 0 0 ] 0 0 2 m 0 0 0 0 k 0 2
2 X 0 0 0 ^ 2 0 0 0 0 ^ 2 U 0 0 ^ ^ 2 k 0 0 k 0 0 0 2 0 0 0 0 0 0 m 2 0 0 0 0 0 0 m 2
2 i 0 0 0 0 0 0 0 0 0 0 0 0 0 0 0 0 : 0 0 0 0 0 0 0 : 0 0 0 0 0 0 0 : 0 0 n 2 l 0 n 2
2 X 0 0 0 ^ 2 0 0 0 0 ^ 2 0 0 0 ^ ^ 2 0 0 0 0 0 0 0 2 0 0 0 0 0 m 0 2 0 0 0 0 0 0 0 2
2 2 2 9 2 2 2 2 2 8 2 2 2 2 2 7 2 2 2 0 0 k 0 0 k 0 2 0 0 0 0 0 0 0 2 0 k 0 0 0 0 k 2
2 0 0 0 0 0 2 0 0 0 0 0 2 0 0 0 0 0 2 2 k 0 0 k 0 2 2 m 0 0 0 0 0 m 2 2 0 0 0 0 m 2 2
2 0 0 0 0 0 2 0 0 0 0 0 2 0 0 0 0 0 2 2 2 2 ; 2 2 2 2 2 2 2 ; 2 2 2 2 2 2 2 9 2 2 2 2
2 0 W L W 0 2 0 W 0 W 0 2 0 W I W 0 2 2 2 0 0 0 2 2 2 2 2 0 0 0 2 2 2 2 2 ^ 0 ^ 2 2 2
2 0 0 W 0 0 2 0 0 W 0 0 2 0 0 W 0 0 2 2 2 0 0 0 2 2 2 2 2 0 0 0 2 2 2 2 2 ^ 0 ^ 2 2 2
2 0 0 0 0 0 2 0 0 0 0 0 2 0 0 0 0 0 2 2 2 V A V 2 2 2 2 2 W @ W 2 2 2 2 2 ^ b ^ 2 2 2
2 2 2 2 2 2 2 2 2 2 2 2 2 2 2 2 2 2 2 2 2 2 2 2 2 2 2 2 2 2 2 2 2 2 2 2 2 2 2 2 2 2 2
